11111111111111
10000000000001
1000000000E001
11111111100001
10C00000000001
111110P0000001
11111111111111
