111111111111111111
100000000000000001
100000C00000E00001
1000000P0000000001
100000000000000001
111111111111111111
