1111111111111111
11101CE1000C0001
1000100001101111
1001100000000001
100P001111100C01
11101C010000C001
100C000000011101
10000000000000C1
1111111110000001
1000000000000001
1001000011111001
11111000000C0001
10C0000001111001
1111111111111111
