111111111111
111110000001
1P00C0000001
111110000001
10E001000001
111111100001
100000000C01
111111111111
