111111111111
111110000001
1P00C1000001
111110000001
100001000001
111111100001
10000E000C01
111111111111
