11111111111111111
11101CE10000C0001
10001000001101111
10011000000000001
10000000000111111
100P0000000000C01
11101C0100000C001
10001000000111111
10011000000000001
10000000000111111
10000000000000001
10000000000000001
10000000000000001
10000000000000001
11111111111111111
